{
  "key": "kcpd_precinct",
  "name": "KC Police Precinct",
  "district": "West Bottoms",
  "rows": [
    "########################################################################",
    "#.............#########################################################",
    "#.....LOBBY...#.......................................................#",
    "#.............#.......................................................#",
    "#.............#.......................................................#",
    "#####+#########.......................................................#",
    "#.............#.......................................................#",
    "#...CELLS.....#.....BULLPEN...........................................#",
    "#.............#.......................................................#",
    "#.........+...#.......................................................#",
    "#.............#########+########.....................................#",
    "#......................................#..............................#",
    "#.....#####.....#####.....#####.......#..............................#",
    "#.....#...#.....#...#.....#...#.......#..............................#",
    "#.....#...#.....#...#.....#...#.......###############################",
    "#.....#####.....#####.....#####.......#",
    "#.......................................#",
    "#.......................................#",
    "#...EVIDENCE ROOM.......................#",
    "#.......................................#",
    "#.......................................#",
    "#.......................................#",
    "#.......................................#",
    "########################################",
    "########################################################################",
    "########################################################################",
    "########################################################################",
    "########################################################################",
    "########################################################################",
    "########################################################################",
    "########################################################################",
    "########################################################################",
    "########################################################################",
    "########################################################################",
    "########################################################################",
    "########################################################################",
    "########################################################################",
    "########################################################################"
  ],
  "char_map": {
    "#": "wall",
    ".": "floor",
    "+": "door_closed"
  },
  "spawn_points": {
    "player": [3, 2],
    "npcs": [
      {"key": "detective_flynn", "x": 25, "y": 8},
      {"key": "beat_cop", "x": 10, "y": 3},
      {"key": "beat_cop", "x": 15, "y": 8},
      {"key": "captain_morrison", "x": 65, "y": 12}
    ],
    "items": [
      {"key": "forged_documents", "x": 8, "y": 19}
    ],
    "objectives": [
      {"type": "exit", "x": 1, "y": 2, "label": "Front Door — Get Out Clean"},
      {"type": "loot", "x": 8, "y": 18, "label": "Evidence Room Files"}
    ]
  }
}
