{
  "key": "river_market_warehouse",
  "name": "River Market Warehouse",
  "district": "River Market",
  "rows": [
    "########################################################################",
    "#......................................................................#",
    "#..CCCC...CCCC...CCCC...CCCC...CCCC...CCCC...CCCC...CCCC...CCCC.......#",
    "#..CCCC...CCCC...CCCC...CCCC...CCCC...CCCC...CCCC...CCCC...CCCC.......#",
    "#......................................................................#",
    "#......................................................................#",
    "#..CCCC...CCCC...CCCC...CCCC...CCCC...CCCC...CCCC...CCCC...CCCC.......#",
    "#..CCCC...CCCC...CCCC...CCCC...CCCC...CCCC...CCCC...CCCC...CCCC.......#",
    "#......................................................................#",
    "#......................................................................#",
    "####################.###########.######################################",
    "#......................................................................#",
    "#......................................................................#",
    "#..CCCC...CCCC...CCCC.......................CCCC...CCCC...CCCC.........#",
    "#..CCCC...CCCC...CCCC.......................CCCC...CCCC...CCCC.........#",
    "#......................................................................#",
    "#.......................#############.......................................#",
    "#.......................#...........#.......................................#",
    "#.......................#...........#.......................................#",
    "#.......................#...........#.......................................#",
    "#.......................#############.......................................#",
    "#......................................................................#",
    "#......................................................................#",
    "#......................................................................#",
    "#######################################################################",
    "########################################################################",
    "########################################################################",
    "########################################################################",
    "########################################################################",
    "########################################################################",
    "########################################################################",
    "########################################################################",
    "########################################################################",
    "########################################################################",
    "########################################################################",
    "########################################################################",
    "########################################################################",
    "########################################################################"
  ],
  "char_map": {
    "#": "wall",
    ".": "floor",
    "C": "crate"
  },
  "spawn_points": {
    "player": [3, 1],
    "npcs": [
      {"key": "the_ox", "x": 55, "y": 18},
      {"key": "dago_deluca", "x": 35, "y": 12},
      {"key": "made_man", "x": 20, "y": 6},
      {"key": "made_man", "x": 50, "y": 6}
    ],
    "items": [
      {"key": "whiskey_case", "x": 10, "y": 3},
      {"key": "whiskey_case", "x": 15, "y": 3}
    ],
    "objectives": [
      {"type": "exit", "x": 70, "y": 23, "label": "Loading Dock — River Exit"},
      {"type": "loot", "x": 55, "y": 17, "label": "Syndicate Cash Box"}
    ]
  }
}
