{
  "key": "the_blue_room",
  "name": "The Blue Room",
  "district": "18th and Vine",
  "rows": [
    "########################################################################",
    "#......................................................................#",
    "#..BBBBBBBBBB..........................................................#",
    "#..B..........................................................#",
    "#..BBBBBBBBBB..........................................................#",
    "#......................................................................#",
    "#......................................................................#",
    "#...####.......################################################........#",
    "#...#..#.......#..............................................#........#",
    "#...#..#.......#..............................................#........#",
    "#...####.......#..............................................#........#",
    "#..............################################################........#",
    "#......................................................................#",
    "#......................................................................#",
    "#...CCCC.......................................................CCCC....#",
    "#...CCCC.......................................................CCCC....#",
    "#......................................................................#",
    "#......................................................................#",
    "#......................................................................#",
    "#...####.....####.....####.....####.....####.....####.....####.........#",
    "#...#..#.....#..#.....#..#.....#..#.....#..#.....#..#.....#..#.........#",
    "#...#..#.....#..#.....#..#.....#..#.....#..#.....#..#.....#..#.........#",
    "#...####.....####.....####.....####.....####.....####.....####.........#",
    "#......................................................................#",
    "#......................................................................#",
    "#######################################################################",
    "########################################################################",
    "########################################################################",
    "########################################################################",
    "########################################################################",
    "########################################################################",
    "########################################################################",
    "########################################################################",
    "########################################################################",
    "########################################################################",
    "########################################################################",
    "########################################################################",
    "########################################################################"
  ],
  "char_map": {
    "#": "wall",
    ".": "floor",
    "B": "bar_counter",
    "C": "crate"
  },
  "spawn_points": {
    "player": [5, 1],
    "npcs": [
      {"key": "dutch_malone", "x": 50, "y": 10},
      {"key": "mama_dolores", "x": 20, "y": 3},
      {"key": "rival_goon", "x": 35, "y": 16}
    ],
    "items": [
      {"key": "whiskey_case", "x": 3, "y": 14}
    ],
    "objectives": [
      {"type": "exit", "x": 70, "y": 24, "label": "Back Alley Exit"}
    ]
  }
}
