{
  "key": "union_station_interior",
  "name": "Union Station",
  "district": "Union Station",
  "rows": [
    "########################################################################",
    "#......................................................................#",
    "#......................................................................#",
    "#....#######.....#######.....#######.....#######.....#######...........#",
    "#....#.....#.....#.....#.....#.....#.....#.....#.....#.....#...........#",
    "#....#.....#.....#.....#.....#.....#.....#.....#.....#.....#...........#",
    "#....#######.....#######.....#######.....#######.....#######...........#",
    "#......................................................................#",
    "#......................................................................#",
    "##########.###########.###########.###########.###########.############",
    "#.........................................................................#",
    "#.....CCCCC...........................................................BB..#",
    "#.....CCCCC...........................................................BB..#",
    "#.....CCCCC.....................................................BBBBBB..#",
    "#......................................................................#",
    "#......................................................................#",
    "##########.###########.###########.###########.###########.############",
    "#......................................................................#",
    "#......................................................................#",
    "#....#######.....#######.....#######.....#######.....#######...........#",
    "#....#.....#.....#.....#.....#.....#.....#.....#.....#.....#...........#",
    "#....#.....#.....#.....#.....#.....#.....#.....#.....#.....#...........#",
    "#....#######.....#######.....#######.....#######.....#######...........#",
    "#......................................................................#",
    "#......................................................................#",
    "#......................................................................#",
    "#######################################################################",
    "########################################################################",
    "########################################################################",
    "########################################################################",
    "########################################################################",
    "########################################################################",
    "########################################################################",
    "########################################################################",
    "########################################################################",
    "########################################################################",
    "########################################################################",
    "########################################################################"
  ],
  "char_map": {
    "#": "wall",
    ".": "floor",
    "+": "door_closed",
    "B": "bar_counter",
    "C": "crate"
  },
  "spawn_points": {
    "player": [3, 2],
    "npcs": [
      {"key": "big_jim_torrio", "x": 60, "y": 12},
      {"key": "rival_goon", "x": 40, "y": 7},
      {"key": "beat_cop", "x": 35, "y": 18}
    ],
    "items": [
      {"key": "whiskey_case", "x": 12, "y": 11}
    ],
    "objectives": [
      {"type": "exit", "x": 69, "y": 24, "label": "Platform 7 — Freight Exit"}
    ]
  }
}
